N ./images/graystone.xpm
SO ./images/mossystone.xpm
EA ./images/redbrick.xpm
WE ./images/eagle.xpm
C 47,47,47
F 142,142,142

11111111111111111111111111111111111111
1010000000000000000000001000100000000111111
1010000000000000000000001000100000000000001
1110000000000000000000001111100000000111111
10000000000000000000000000000000000001
10000000000000000000000000000000000001
10000000000000000000000000000000000001
100000000000000000N0000000000000000001
10000000000000000000000000000000000001
10000000000000000000000000000000000001
10000000000000000000000000000000000001
10000000000000000000000000000000000001
10000000000000000000000000000000000001
10000000000000001111111100000000000001
10000000000000001  1000100000000000001
10000000000000001  1000100000000000001
11111111111111111  1111111111111111111
